######################
|  #  #           L__#
#  #  #  ####  #  ####
#  #     #           #
#  #  #  E  ####  #  #
#   E #     #        #
#  T  ####  ####  ####
#        #  #     #  #
#  #############  #  #
#  #  #     E     #  #
#  #  #   ###  #  #  #
#  #  #        #     #
#  #  #############  #
#        #           |
######################
