##################
|     #   #      #
####  #   #     ##
#       E   L__  #
####  #    #######
#     #          #
#  #  #T   #  #  #
#  #  #    #  #  #
#######    ####  #
#       T     #  |
##################
