######################
|  #  #         |---|#
#  #  #  ####  #  ####
#  #     #           #
#  #  #  E  ####  #  #
#   E #     #        #
#     ####  ####  ####
# T      #  #     #  #
#  #############  #  #
#  #  #     E     #  #
#  #  #   ###  #  #  #
#  #  #        #     #
#  #  #############  #
#        #         []|
######################  
