##################
|     #   #      #
####  #   #     ##
#           |---|#
####  #    #######
#     #    []    #
#  #  #T   #  #  #
#  #  #    #  #  #
#######    ####  #
#       T     #  |
##################
